48 10 0 151 122 32 64 
49 10 0 435 122 32 64 
50 10 0 654 122 32 64 
52 10 0 946 123 32 64 
53 10 0 1192 122 32 64 
1 12 0 0 58 1504 32 
